     ##L##L##  
    ##T T   ## 
 ####        ##
 #EP          $
 ####        ##
    ##      ## 
     ########