     ##L##L##  
    ##TSS  M## 
 ####  M     ##
 #EP          #
 ####        ##
    ##      ## 
     ########