#L#L#L#L#         ################## 
$P      #         #               C# 
#       #         #               F# 
######  #         #  ############### 
     #  #         #  #
     #  #         #  #
     #  #L##L#L##L#  #
     #               #
     #               #
     #  ##############
     #  #
     #  #
######  #
#C      #
#       #
######### 