#L#L#L#L#         ################## 
$P      #         #               C# 
#       #         #               FE 
######  #         #  ############### 
     #  #         #  #
     #  #         #  #
     #  #L##L#L##L#  #
     #               #
     #               #
     #  ##############
     #  #
     #  #
######  #
#C      #
#T      #
######### 